1 13 31
###############################
#p     ** *    * 1 *  * * * 2 #
# # # #*# # #*#*# # # #*#*#*# #
#   *     s**  *  2   *   * * #
# # # # # #*# # #*#*# # # # #*#
#f           **  *  *    1    #
# # # # # # # # s #*# #*# # # #
#*  *      *  *      *        #
# # # # #*# # # #*#*# s # # # #
#*    **  *  1    *     *     #
# #*# # # # # # #*# # # s # # #
#2       f  *   *  *    1    *#
#############################x#