1 13 31
###############################
#p     ** *  1 * 2 *  * * *   #
# # # #*# # #*#*# # # #*#*#*# #
#   *     s**  *  1   * 2 * * #
# # # # # #*# # #*#*# # # # #*#
#f         2 **  *  *   1     #
# # # # # # # # s #*# #*# # # #
#*  *      *  *      *   2    #
# # # # #*# # # #*#*# # # # # #
#*    **  *       *     *     #
# #*# # # # # # #*# # # s # # #
#2       f  *   *  *         x#
###############################