1 13 31
###############################
#p     ** *  1 *  *  * * *    #
# # # #*# # #*#*# # # #*#*#*# #
#   *     s**  *     *  * *   #
# # # # # #*# # #*#*# # # # #*#
#f          **  *  *          #
# # # # # # # # s #*# #*# # # #
#*  *      *  *      *        #
# # # # #*# # # #*#*# # # # # #
#*    **  *       *     *     #
# #*# # # # # # #*# # # s # # #
#        f  *   *  *         x#
###############################